#######
#    B#
#     #
#  A A#
#     #
#######