#######
#....B#
#.    #
#.    #
#A    #
#######
