#####   ########   
#A  #####      #   
#..........    #   
#   ######...  ####
#####    ###.....B#
           ########
