#####   ########   
#A  #####      #   
#              #   
#   ######     ####
#####    ###     B#
           ########