#####   ########   
#A  #####      #   
#              #   
#   ######     ####
#####    ###    #B#
           ########