#######
#    B#
#     #
#     #
#     #
#######